_________________F
S_________________
__________________
_________________g
g_______________gg
gg_______________g
ggg___________g__g
g_gg_____________g
g__gg___________gg
g___gg___________g
gi___gg_______g__g
gg____gg_________g
g______gg_______gg
g____i__gg_______g
g__^_g___gg___g__g
g__g______gg_____g
g______^___gg___gg
g______g____gg___g
g^^iii^^iii^igg__g
gggggggggggggggggg
